{
    "map_size" : [9, 12], 

    "map" : [
        [0, 0, 0, 0, 0, 0, 0, 0, 0, 0, 0, 0],
        [0, 0, 0, 0, 0, 0, 0, 0, 0, 0, 0, 0],
        [0, 0, 0, 3, 3, 3, 0, 0, 0, 0, 0, 0],
        [0, 0, 0, 3, 0, 3, 0, 0, 0, 0, 0, 0],
        [0, 0, 2, 3, 0, 3, 3, 3, 3, 1, 0, 0],
        [0, 0, 0, 0, 0, 0, 0, 0, 0, 0, 0, 0],
        [0, 0, 0, 0, 0, 0, 0, 0, 0, 0, 0, 0],
        [0, 0, 0, 0, 0, 0, 0, 0, 0, 0, 0, 0],
        [0, 0, 0, 0, 0, 0, 0, 0, 0, 0, 0, 0]
    ],

    "difficulty" : 100,
    "start_wave" : 0,
    "start_money" : 1000000000000
}