{
    "map_size" : [9, 12], 

    "map" : [
        [0, 0, 0, 0, 0, 0, 0, 0, 0, 0, 0, 0],
        [0, 0, 0, 0, 0, 0, 0, 0, 0, 0, 0, 0],
        [0, 3, 3, 3, 0, 3, 3, 3, 0, 0, 0, 0],
        [0, 3, 0, 3, 0, 3, 0, 3, 0, 0, 0, 0],
        [0, 2, 0, 3, 0, 3, 0, 3, 0, 0, 0, 0],
        [0, 0, 3, 3, 0, 3, 0, 1, 0, 0, 0, 0],
        [0, 0, 3, 0, 0, 3, 0, 0, 0, 0, 0, 0],
        [0, 0, 3, 3, 3, 3, 0, 0, 0, 0, 0, 0],
        [0, 0, 0, 0, 0, 0, 0, 0, 0, 0, 0, 0]
    ],

    "difficulty" : 102,
    "start_wave" : 0,
    "start_money" : 150,
    "start_hit" : 20
}