{
    "map_size" : [9, 12], 

    "map" : [
        [0, 0, 0, 0, 0, 0, 0, 0, 0, 0, 0, 0],
        [0, 2, 3, 3, 0, 3, 3, 3, 0, 0, 1, 0],
        [0, 0, 0, 3, 0, 3, 0, 3, 0, 0, 3, 0],
        [0, 0, 0, 3, 0, 3, 0, 3, 0, 0, 3, 0],
        [0, 3, 3, 3, 0, 3, 0, 3, 0, 0, 3, 0],
        [0, 3, 0, 0, 0, 3, 0, 3, 0, 0, 3, 0],
        [0, 3, 3, 3, 3, 3, 0, 3, 0, 0, 3, 0],
        [0, 0, 0, 0, 0, 0, 0, 3, 3, 3, 3, 0],
        [0, 0, 0, 0, 0, 0, 0, 0, 0, 0, 0, 0]
    ],

    "difficulty" : 108,
    "start_wave" : 0,
    "start_money" : 200,
    "start_hit" : 25
}