{
    "map_size" : [9, 12], 

    "map" : [
        [0, 0, 0, 0, 0, 0, 0, 0, 0, 0, 0, 0],
        [0, 2, 3, 3, 3, 3, 3, 3, 3, 3, 3, 0],
        [0, 0, 0, 0, 0, 0, 0, 0, 0, 0, 3, 0],
        [0, 0, 0, 0, 0, 0, 0, 0, 0, 0, 3, 0],
        [0, 0, 0, 0, 0, 0, 0, 0, 0, 0, 3, 0],
        [0, 0, 0, 0, 0, 0, 0, 0, 0, 0, 3, 0],
        [0, 0, 0, 0, 0, 0, 0, 0, 0, 0, 3, 0],
        [0, 1, 3, 3, 3, 3, 3, 3, 3, 3, 3, 0],
        [0, 0, 0, 0, 0, 0, 0, 0, 0, 0, 0, 0]
    ],

    "difficulty" : 106,
    "start_wave" : 0,
    "start_money" : 160,
    "start_hit" : 20
}